showBtn|Zobrazit panel prohl칤쬰n칤
printBtn|Vytisknout
nav-left|P콏edchoz칤
nav-top|O 칰rove켿 v칳코
nav-right|N치sleduj칤c칤
downP-Hide|Skr칳t panel
downP-ToggleFS|P콏epnout full screen
downP-SwitchColorMode|Zm캩nit sch칠ma barev
downP-ChangeLanguage|Zm캩nit jazyk prost콏ed칤
downP-Home|Dom콢
downP-TopicTree|Seznam t칠mat
HEADING_SELECT_LEFT|Vyberte polo쬶u z panelu prohl칤쬰n칤
downP-ChapterAnchor|캛치sti vybran칠 kapitoly
downP-Glossary|Slovn칤k kl칤캜ov칳ch slov
downP-Fulltext|Fulltextov칠 vyhled치v치n칤
keywordList-i__placeholder|Zadejte slovo, stiskn캩te Enter
fulltextList-i__placeholder|Zadejte slovo, stiskn캩te Enter
keywordList-i|Zadejte slovo, stiskn캩te Enter
fulltextList-i|Zadejte slovo, stiskn캩te Enter
downP-ToggleSide|P콏esunout panel na druhou stranu
toolbar__aria-label|M칤stn칤 navigace t칠matu
sidebar__aria-label|Hlavn칤 navigace
_viewRepo-h1|游 Pod칤vejte se na sv콢j repozit치콏
_viewRepo-par1|Tento pr콢vodce v치m pom콢쬰 zobrazit vlastn칤 칰lo쬴코t캩 v aplikaci HelpViewer. Nejedn치 se o migraci - n캩kter칠 funkce jsou omezen칠 nebo je코t캩 nemus칤 fungovat. Ale m콢쬰 to b칳t pr치v캩 prvn칤 krok k v칳b캩ru n치stroje, kter칳 v치m bude vyhovovat. Sta캜칤 zadat n캩kter칠 informace n칤쬰 a kliknut칤m na vygenerovan칳 odkaz za캜칤t.
_viewRepo-par2|游띋 Tento n치hled pou쮂셨치 ve콏ejn칳 obsah z GitHubu.<br />Pokud je v치코 repozit치콏 soukrom칳, n치hled nebude fungovat.<br />V코e se spou코t칤 pouze v prohl칤쬰캜i.
_viewRepo-link|Odkaz
_viewRepo-org|Organizace/U쬴vatel
_viewRepo-repo|Repozit치콏
_viewRepo-branch|V캩tev/Tag
_viewRepo-langs|Podslo쬶y s jazyky
_viewRepo-zip|Proch치zet ZIP release
downP-ChangeVersion|Naj칤t jinou verzi n치pov캩dy
versionList|Historie verz칤
downP-ShowAsBook|Zobrazit v코echny kapitoly jako jeden dokument
helpfile|Soubor n치pov캩dy
version|Verze
source|Zdroj
cbPageBreak|Zalomen칤 str치nky na konci kapitoly
IconPrint|Tisk ikonek
IconPrintItems|Odebrat;Ponechat;Podle autora
editRepoBtn|Editovat v repozit치콏i
date|Datum
downP-TogglePresMode|Prezenta캜n칤 re쬴m
downP-UserNotes|Pozn치mky
notes-add|P콏idat pozn치mku
